state,district,year,total_population,area_km2,dwellings_total,dwellings_occupied,dwellings_empty,households_total,households_single,household_size_avg,sex_male,sex_female,nationality_citizen,nationality_non_citizen,ethnicity_bumi,ethnicity_chinese,ethnicity_indian,ethnicity_other,age_0_14,age_15_64,age_65_above,marital_of_age,marital_never_married,marital_married,marital_widowed,marital_separated,marital_unknown,religion_muslim,religion_christian,religion_buddhist,religion_hindu,religion_other,religion_atheist,religion_unknown,density_urban,density_rural
Johor,Batu Pahat,2020,495338,1966,129486,105356,24130,116252,110189,4.00,261609,233729,465143,30195,316367,140103,6910,1763,105923,356460,32955,389415,159048,211339,13635,5010,383,330803,14565,129831,13484,5570,1085,0,309750,185588
Johor,Johor Bahru,2020,1711191,1066,610314,449848,160466,460669,456820,3.60,907315,803876,1588023,123168,826819,606262,144991,9951,450281,1200502,60408,1260910,428860,776542,31571,23545,392,883183,75957,566112,156071,15094,14773,1,1702424,8767
Johor,Kluang,2020,323762,2865,94101,78214,15887,81993,80763,3.70,179314,144448,289981,33781,171424,92320,24842,1395,75113,224904,23745,248649,83548,148113,13305,3596,87,193955,6792,91720,28316,1274,1704,1,225555,98207
Johor,Kota Tinggi,2020,222382,3489,70315,54759,15556,57786,56933,3.70,118422,103960,208575,13807,183576,18630,5541,828,52555,151798,18029,169827,57803,99096,10820,2085,23,194191,2326,18315,6281,545,724,0,107232,115150
Johor,Mersing,2020,78195,2857,21815,18600,3215,20673,20201,3.60,41939,36256,74072,4123,65887,7119,864,202,18786,53606,5803,59409,20485,34383,3761,751,29,67527,992,6953,1128,491,1104,0,22553,55642
Johor,Muar,2020,314776,1393,79980,64539,15441,69603,67004,4.20,173296,141480,280956,33820,174423,100430,5452,651,71991,223265,19520,242785,97778,132260,10542,2188,17,196033,5137,101002,10155,1546,903,0,180241,134535
Johor,Pontian,2020,173318,933,46692,42115,4577,42519,42286,4.00,93247,80071,159983,13335,115269,42608,1367,739,40237,118845,14236,133081,45959,77854,7499,1743,26,125176,1894,41562,3326,1126,234,0,83930,89388
Johor,Segamat,2020,197762,2867,65038,51424,13614,52855,51690,3.60,103200,94562,186121,11641,106696,63132,15711,582,39953,138242,19567,157809,58646,88748,8105,2244,66,113382,2099,62404,16807,1063,2006,1,104669,93093
Johor,Kulai,2020,329497,756,83756,66200,17556,77199,75873,3.70,177734,151763,282299,47198,155332,95259,30225,1483,68754,244354,16389,260743,120385,129752,7237,3363,6,181646,9741,91809,37923,3760,4617,1,291941,37556
Johor,Tangkak,2020,163449,977,43438,35534,7904,38178,37665,4.10,85231,78218,155350,8099,103381,42789,8392,788,35717,117087,10645,127732,50246,68390,6937,2139,20,108783,1963,41096,9226,1883,498,0,75189,88260
Kedah,Baling,2020,142643,1529,41987,35114,6873,37438,36039,3.80,73102,69541,139748,2895,128748,4218,4517,2265,38544,93524,10575,103867,35916,59302,6382,961,1306,130000,403,6054,4635,240,4,1307,45148,97495
Kedah,Bandar Baharu,2020,44412,271,12664,10705,1959,11112,10994,3.90,22740,21672,43107,1305,36271,4141,2611,84,11582,29342,3488,33240,11367,18763,2469,356,285,37316,86,3540,2563,620,2,285,11557,32855
Kedah,Kota Setar,2020,374051,420,109919,89567,20352,95942,94306,3.80,186128,187923,361151,12900,269268,83371,7306,1206,94415,247897,31739,271997,80928,163027,16061,4408,7573,274649,2342,81226,6538,1603,120,7573,300448,73603
Kedah,Kuala Muda,2020,544984,913,166581,128271,38310,131802,129790,3.90,280022,264962,509844,35140,366068,83024,58581,2171,130338,369798,44848,382151,114011,228387,15920,4559,19274,376394,5990,81498,57755,3866,206,19275,478314,66670
Kedah,Kubang Pasu,2020,237759,946,72463,55395,17068,58695,56247,3.90,117316,120443,230846,6913,207675,14934,4911,3326,63125,156482,18152,179324,63130,102416,9731,2097,1950,212015,1885,16649,4488,200,571,1951,128858,108901
Kedah,Kulim,2020,337699,774,93407,77947,15460,80772,79544,4.10,173041,164658,318348,19351,221452,47366,48070,1460,79726,230858,27115,233324,72669,142274,8264,2521,7596,230686,3810,46281,46502,2583,241,7596,296845,40854
Kedah,Langkawi,2020,94138,526,33025,25680,7345,25983,25672,3.60,48694,45444,90015,4123,82688,4611,1741,975,24038,63593,6507,68924,21294,41605,3105,1430,1490,85490,940,4523,1579,56,60,1490,88986,5152
Kedah,Padang Terap,2020,65698,1359,19028,15619,3409,15968,15882,4.10,34223,31475,62389,3309,57279,497,28,4585,18013,43000,4685,48427,15580,28818,3300,592,137,58752,206,6467,67,11,58,137,0,65698
Kedah,Sik,2020,67925,1635,19135,17254,1881,17421,17279,3.80,34674,33251,65808,2117,61813,513,57,3425,18668,44401,4856,50239,14493,31203,3279,598,666,63010,42,4087,55,20,1,710,9707,58218
Kedah,Yan,2020,73384,246,17983,15331,2652,16927,16826,4.30,37659,35725,72802,582,69938,2734,63,67,19925,47866,5593,51001,15558,31260,3394,560,229,70332,72,2673,36,37,5,229,33969,39415
Kedah,Pendang,2020,98922,629,29614,23814,5800,24077,23879,4.10,52476,46446,97010,1912,88054,2832,413,5711,27166,64462,7294,68160,19645,43015,4145,849,506,89036,207,8350,347,460,16,506,21833,77089
Kedah,Pokok Sena,2020,49812,244,15249,11954,3295,12091,11914,3.70,27211,22601,47012,2800,43502,2359,757,394,13304,32848,3660,37784,12369,20803,2468,1200,944,44940,290,2628,885,120,5,944,19676,30136
Kelantan,Bachok,2020,157288,279,37058,29966,7092,31355,30641,4.90,76210,81078,156130,1158,154240,1354,112,424,43156,104538,9594,114132,47556,58978,5885,1435,278,155139,160,1583,100,18,10,278,0,157288
Kelantan,Kota Bharu,2020,555757,403,133413,108423,24990,115485,113394,4.50,277807,277950,544531,11226,524700,16879,1390,1562,147669,372078,36010,408088,172652,202004,22060,6254,5118,531584,2916,15692,1189,340,147,3889,510456,45301
Kelantan,Machang,2020,110008,526,25946,20824,5122,21963,20864,4.90,54680,55328,108988,1020,106799,1972,104,113,35996,66567,7445,74012,31130,37272,4296,1212,102,107648,207,1960,117,46,11,19,26376,83632
Kelantan,Pasir Mas,2020,230424,570,54924,42988,11936,45128,44471,5.10,116756,113668,227898,2526,223711,3343,29,815,71914,142373,16137,158510,63770,80840,10986,2359,555,225777,231,3849,5,6,3,553,50337,180087
Kelantan,Pasir Puteh,2020,136157,423,33404,26044,7360,26440,26105,5.10,67447,68710,135280,877,133762,621,74,823,44505,81775,9877,91652,35535,48443,5459,2002,213,134566,166,1244,42,73,1,65,24532,111625
Kelantan,Tanah Merah,2020,150766,880,34696,28823,5873,30134,29536,5.00,77481,73285,146520,4246,140777,4697,375,671,46734,94652,9380,104032,39885,56444,5849,1441,413,143648,484,5017,434,17,933,233,57221,93545
Kelantan,Tumpat,2020,179943,180,42113,33715,8398,34817,34510,5.20,89192,90751,178503,1440,165052,7362,176,5913,61235,107044,11664,118708,44267,63925,8163,1926,427,166415,351,13016,83,34,17,27,63120,116823
Kelantan,Gua Musang,2020,101886,6362,25763,18512,7251,20324,20078,5.00,54745,47141,94527,7359,88598,4758,834,337,36763,60881,4242,65123,22846,35962,2560,782,2973,87932,1465,4654,765,2422,3372,1276,31322,70564
Kelantan,Kuala Krai,2020,105007,2275,28982,23131,5851,23862,23636,4.40,52863,52144,101255,3752,96637,3538,846,234,30366,67826,6815,74641,26296,41219,4975,1219,932,99601,275,3562,922,73,1,573,27048,77959
Kelantan,Jeli,2020,54656,1326,11451,9282,2169,11620,10888,4.60,27373,27283,53259,1397,52863,142,175,79,14706,37254,2696,39950,18531,18337,2127,533,422,53827,243,115,149,8,10,304,0,54656
Kelantan,Kecil Lojing,2020,10609,1817,2604,2151,453,2123,2110,5.00,5509,5100,10308,301,9692,10,590,16,4051,6305,253,6558,2317,3830,286,117,8,6126,352,33,15,270,3813,0,0,10609
Melaka,Alor Gajah,2020,249356,674,71937,48134,23803,67558,61853,3.60,128761,120595,231231,18125,184476,27861,18231,663,48058,185949,15349,201298,82841,98694,9035,3290,7438,191253,2712,28284,18679,1082,699,6647,206826,42530
Melaka,Jasin,2020,151937,679,51148,35876,15272,39361,37036,3.70,81756,70181,138701,13236,113207,12945,12024,525,29972,109947,12018,121965,47270,60567,6694,1411,6023,118087,1642,13097,12542,648,239,5682,103976,47961
Melaka,Melaka Tengah,2020,597135,359,196668,139728,56940,160155,157303,3.60,314425,282710,557429,39706,366952,164433,22104,3940,155923,405329,35883,441212,150268,244977,19012,6079,20876,378361,21928,150336,21419,3116,1307,20668,597135,0
Negeri Sembilan,Jelebu,2020,46053,1354,13349,10430,2919,11129,11048,4.10,25030,21023,43151,2902,30712,10379,1844,216,13934,28024,4095,32119,9558,19166,2251,605,539,30842,666,9832,1739,139,2832,3,0,46053
Negeri Sembilan,Kuala Pilah,2020,70331,1027,24008,18192,5816,18715,18586,3.50,35985,34346,68539,1792,55528,9199,3600,212,16144,48222,5965,54187,20577,29686,2930,902,92,55825,515,9032,3610,529,820,0,21394,48937
Negeri Sembilan,Port Dickson,2020,128689,583,50398,31350,19048,32697,32150,3.80,68275,60414,122589,6100,67695,31236,22893,765,33441,87812,7436,95248,34351,54180,4468,1043,1206,71939,2448,29892,22240,1716,451,3,89891,38798
Negeri Sembilan,Rembau,2020,47296,406,16117,11486,4631,12722,11591,3.70,23974,23322,45528,1768,39382,2301,3756,89,10003,33046,4247,37293,15542,18368,2541,669,173,40068,332,2205,3912,179,600,0,0,47296
Negeri Sembilan,Seremban,2020,692283,954,224691,171911,52780,185707,180489,3.70,358074,334209,647288,44995,386177,154915,102476,3720,168925,481573,41785,523358,187569,302922,20845,9149,2873,411915,23152,148411,98714,5864,3205,1022,647480,44803
Negeri Sembilan,Tampin,2020,88123,851,27086,21992,5094,22233,22135,3.90,46801,41322,83289,4834,52091,19342,11614,242,25313,55870,6940,62810,19192,39003,3793,762,60,54492,2224,19453,11427,291,236,0,39712,48411
Negeri Sembilan,Jempol,2020,127199,1485,36982,31242,5740,32294,32096,3.90,65835,61364,121845,5354,84836,21084,15450,475,34316,82087,10796,92883,28228,57522,5724,1112,297,86474,1986,19458,15912,1068,2300,1,33229,93970
Pahang,Bentong,2020,116799,1831,39466,30834,8632,30223,25710,3.80,66163,50636,108357,8442,66744,31502,9184,927,29067,79319,8413,87363,38519,43027,3867,1734,216,69049,1954,31709,9835,681,3568,3,72544,44255
Pahang,Cameron Highlands,2020,39004,712,15980,9557,6423,9798,9741,4.00,22225,16779,33735,5269,17337,11673,4415,310,9287,26851,2866,28844,9722,17601,922,191,408,15549,1700,11748,4870,1701,3435,1,10383,28621
Pahang,Jerantut,2020,96006,7561,26579,21832,4747,22278,21999,4.30,51142,44864,91148,4858,76832,11099,2659,558,27056,62828,6122,69217,25189,38813,3982,770,463,78418,648,11037,3035,200,2668,0,41436,54570
Pahang,Kuantan,2020,548014,2960,154355,127646,26709,145270,139677,3.80,285191,262823,531284,16730,439144,75183,14264,2693,139646,373770,34598,393930,135274,239885,13152,5283,336,449679,8421,70498,13613,1574,4227,2,454422,93592
Pahang,Lipis,2020,96620,5198,23255,20440,2815,21013,20764,4.50,51179,45441,92297,4323,81343,7339,3336,279,26412,64946,5262,70085,25619,39711,3070,1038,647,71797,4114,7014,3321,2163,8208,3,18844,77776
Pahang,Pekan,2020,121158,3805,33125,26564,6561,32130,29944,3.50,65389,55769,112921,8237,108706,1471,1077,1667,30557,85240,5361,91799,37149,46799,4923,1174,1754,104598,555,1748,1711,124,12419,3,39629,81529
Pahang,Raub,2020,96139,2269,25294,22016,3278,22918,22288,4.10,50909,45230,90838,5301,55494,29471,5473,400,25323,63799,7017,70214,24693,41089,3446,857,129,54342,1585,29297,6299,2256,2360,0,38663,57476
Pahang,Temerloh,2020,169023,2251,52014,41431,10583,42269,41851,4.00,87304,81719,163731,5292,129078,24128,9559,966,49470,107563,11990,116012,34908,73712,5162,1667,563,126947,3128,22464,9623,609,6248,4,100922,68101
Pahang,Rompin,2020,98065,5247,33471,26540,6931,27110,27001,3.60,53497,44568,89703,8362,86628,1572,916,587,27237,66136,4692,72395,23206,43327,4079,1087,696,80854,626,1999,1206,243,13135,2,10476,87589
Pahang,Maran,2020,112330,1917,29766,24481,5285,25147,24517,4.30,58711,53619,107497,4833,103262,2767,1131,337,33827,71621,6882,82116,30301,44078,6139,1268,330,105100,299,2884,1523,32,2491,1,19072,93258
Pahang,Bera,2020,98137,2214,25667,22122,3545,23378,23266,4.20,52441,45696,91719,6418,61899,25507,3838,475,26725,64346,7066,72772,25455,40846,4287,1635,549,61072,1134,25279,3973,823,5853,3,33244,64893
P.Pinang,Seberang Perai Tengah,2020,422990,238,127549,52580,25822,106330,103000,3.90,224706,198284,377594,45396,186729,150640,37984,2241,85834,313012,24144,334970,124415,179588,13810,4669,12488,207103,12625,143930,39024,6994,831,12483,410825,12165
P.Pinang,Seberang Perai Utara,2020,339095,268,100841,101727,15748,86971,85742,3.80,172448,166647,322729,16366,203492,95615,22565,1057,74308,243401,21386,255269,79850,149369,12492,4481,9077,212750,5362,90860,23298,5775,608,442,289232,49863
P.Pinang,Seberang Perai Selatan,2020,184007,242,63243,85093,10663,54648,53146,3.20,92765,91242,172525,11482,76598,65314,30128,485,38366,137580,8061,142980,36186,91742,5871,1947,7234,79647,3606,60669,28873,3659,330,7223,164912,19095
P.Pinang,Timur Laut,2020,556575,126,205559,163423,42136,177231,168192,3.10,282432,274143,503633,52942,121900,324943,51520,5270,99845,409301,47429,444310,144389,246504,20780,10770,21867,154898,39865,292135,42582,20320,6775,0,556575,0
P.Pinang,Barat Daya,2020,237738,175,89816,68881,20935,70167,69893,3.30,120203,117535,223393,14345,127180,81850,13295,1068,51432,172255,14051,184761,62987,111489,7293,2989,3,137789,13887,67214,12094,5277,1477,0,188834,48904
Perak,Batang Padang,2020,124049,1794,39982,31310,8672,33666,31767,3.60,66926,57123,118923,5126,82118,20694,15303,808,29733,82693,11623,94316,32518,49627,6550,1520,4101,70046,7111,20605,12361,3386,8520,2020,53017,71032
Perak,Manjung,2020,246977,1126,89450,61280,28170,62890,61589,3.80,133068,113909,229612,17365,133517,65855,29417,823,61023,168675,17279,185954,59830,106804,9000,2994,7326,138851,10447,55177,28322,5821,1043,7316,196912,50065
Perak,Kinta,2020,888767,1305,285237,220662,64575,244648,241082,3.50,460836,427931,838278,50489,402680,321739,110294,3565,206522,599045,83200,682245,218791,375429,38149,14180,35696,409834,35533,298133,91733,12085,7011,34438,845003,43764
Perak,Kerian,2020,166352,938,49899,39318,10581,40251,39665,4.10,85680,80672,160713,5639,124465,25322,10246,680,38014,113367,14971,128338,46688,68806,8891,1729,2224,127804,1096,24271,9738,1149,75,2219,56159,110193
Perak,Kuala Kangsar,2020,176060,2562,55199,41195,14004,49186,47336,3.60,89337,86723,171168,4892,113808,33941,22979,440,44057,116239,15764,132003,46987,70440,9324,1829,3423,113144,1478,33832,21472,890,3224,2020,122928,53132
Perak,Larut Dan Matang,2020,269584,1341,85931,69228,16703,70995,69781,3.70,139759,129825,258286,11298,170206,61566,25624,890,66432,176964,26188,203152,64472,113367,14576,4305,6432,173751,4475,58345,23456,2836,293,6428,201368,68216
Perak,Hilir Perak,2020,141959,821,43865,33393,10472,34663,34190,3.80,75894,66065,129429,12530,74304,37511,16968,646,29007,98148,14804,112952,39015,56692,7214,2205,7826,76369,2491,35854,16963,1216,1602,7464,97012,44947
Perak,Hulu Perak,2020,95076,6613,30325,22637,7688,24679,24258,3.80,49407,45669,92456,2620,82179,6949,1746,1582,26778,61038,7260,68298,23109,37990,4306,772,2121,76536,1499,7920,1374,909,6077,761,14370,80706
Perak,Perak Tengah,2020,94573,1282,35318,22995,12323,28763,23273,3.50,48763,45810,90858,3715,88256,900,1474,228,20974,66681,6918,73599,32245,35253,4292,844,965,88669,887,793,1352,336,1937,599,31642,62931
Perak,Kampar,2020,98732,667,40746,27536,13210,28809,27061,3.30,50529,48203,95097,3635,37927,46876,9941,353,19142,68663,10927,79590,32955,38368,5198,854,2215,35059,4909,45197,8588,1249,1775,1955,90796,7936
Perak,Muallim,2020,76688,949,20528,16929,3599,21282,19922,3.40,36725,39963,73488,3200,58254,6512,8249,473,14270,57660,4758,62418,33310,24326,2769,585,1428,55526,4758,6218,7269,1057,949,911,58613,18075
Perak,Bagan Datuk,2020,82785,974,20263,16400,3863,23534,23273,3.40,45898,36887,72923,9862,41240,14340,17130,213,14463,62209,6113,68322,29245,32041,4858,796,1382,47074,865,15164,17800,307,201,1374,29303,53482
Perak,Selama,2020,34439,774,11580,8968,2612,9489,9381,3.60,17416,17023,33606,833,30698,1422,1438,48,8208,22740,3491,26231,9184,14166,2289,408,184,31370,37,1402,1410,28,8,184,0,34439
Perlis,Perlis,2020,284885,819,73104,57778,15326,80850,72455,3.50,142345,142540,278455,6430,247255,20480,5124,5596,58271,204228,22386,226614,87840,116880,14652,3993,3249,250129,1670,26199,3619,525,71,2672,153297,131588
Selangor,Gombak,2020,942400,653,253148,210511,42637,222549,216404,4.20,491788,450612,875430,66970,565310,200496,95503,14121,216473,664780,61147,594797,184118,379103,10069,13293,8214,627052,38928,172400,89997,8261,4059,1703,937001,5399
Selangor,Klang,2020,1088942,632,301407,259091,42316,263449,260159,4.10,590733,498209,990696,98246,541913,251530,189552,7701,231217,780448,77277,776636,254677,473204,16665,15275,16815,606824,41352,232623,184432,18048,5619,44,1084568,4374
Selangor,Kuala Langat,2020,307449,855,95799,78151,17648,79890,78928,3.70,161360,146089,290781,16668,205011,53101,31624,1045,72489,215125,19835,224889,68370,136348,5704,3142,11325,210834,5316,47634,31983,7595,2587,1500,266753,40696
Selangor,Kuala Selangor,2020,281711,1187,88913,67125,21788,76447,67109,3.90,144073,137638,268540,13171,219847,21706,26146,841,68021,196511,17179,199560,65392,120567,6831,2950,3820,229543,2960,20938,25844,896,183,1347,217665,64046
Selangor,Petaling,2020,2298130,487,679812,592779,87033,617686,597067,3.80,1221520,1076610,2087298,210832,1096926,762735,211756,15881,495026,1638187,164917,1632195,568734,1000189,31487,31736,49,1227247,175618,625077,222562,26215,21411,0,2298130,0
Selangor,Sabak Bernam,2020,107057,1004,33750,27740,6010,28398,27825,3.70,55806,51251,102784,4273,78721,19824,3987,252,25964,73776,7317,80312,29386,44191,4573,1605,557,81410,663,18579,3941,2080,384,0,43251,63806
Selangor,Sepang,2020,325244,552,127628,94244,33384,99778,95467,3.10,174576,150668,293203,32041,201683,58160,30468,2892,74930,231021,19293,242030,76517,143029,4735,3843,13906,221158,10544,52919,31214,4612,2933,1864,309147,16097
Selangor,Ulu Langat,2020,1400461,833,431574,368988,62586,387547,372782,3.60,741574,658887,1289287,111174,812440,362293,106092,8462,307221,993244,99996,1010422,369614,598149,17087,16803,8769,889562,64196,317630,101610,18939,8091,433,1367615,32846
Selangor,Ulu Selangor,2020,243029,1749,89865,59705,30160,60666,60121,4.00,129325,113704,232416,10613,174029,26336,30889,1162,58220,169152,15657,172616,58483,104696,5050,3038,1349,180094,4505,24754,29507,1241,2781,147,178389,64640
Terengganu,Besut,2020,154168,1234,41340,34610,6730,36345,35650,4.20,78422,75746,151061,3107,149186,1300,97,478,46406,98550,9212,107762,39896,59124,7211,1450,81,152217,236,1544,139,16,2,14,61426,92742
Terengganu,Dungun,2020,158130,2735,42294,36710,5584,39597,37463,4.10,81270,76860,155158,2972,151381,3337,131,309,45724,105241,7165,112406,43872,61791,5260,1254,229,154244,456,3067,194,84,31,54,111788,46342
Terengganu,Kemaman,2020,215582,2536,57733,50551,7182,52932,52361,4.00,113009,102573,208231,7351,199319,7840,749,323,69793,139178,6611,145789,47931,90467,5350,1634,407,205706,631,8031,937,66,50,161,140711,74871
Terengganu,Kuala Terengganu,2020,229781,210,64340,54552,9788,59678,58977,3.80,115850,113931,225894,3887,217835,7202,538,319,59680,152881,17220,170101,66520,89044,11816,2242,479,220678,825,6988,814,102,86,288,210222,19559
Terengganu,Marang,2020,116605,667,33335,27171,6164,27759,27406,4.20,59428,57177,115060,1545,113291,1506,40,223,33978,76014,6613,82627,29726,46861,4796,1096,148,114807,312,1259,79,61,19,68,64268,52337
Terengganu,Hulu Terengganu,2020,69881,3875,20949,17004,3945,16907,16831,4.00,37051,32830,65984,3897,65570,148,12,254,18072,46344,5465,51809,19209,28009,3486,801,304,68776,67,725,79,4,3,227,13653,56228
Terengganu,Setiu,2020,59651,1304,15555,13163,2392,13763,13408,4.40,30345,29306,58313,1338,58130,65,23,95,17442,38513,3696,42209,16044,22852,2770,499,44,59438,54,76,50,23,7,3,0,59651
Terengganu,Kuala Nerus,2020,145642,398,38903,32735,6168,35392,33200,4.10,72490,73152,143337,2305,140867,1768,510,192,38012,100358,7272,107630,47153,54284,4934,1134,125,142898,347,1692,511,65,58,71,135914,9728
Sabah,Tawau,2020,372615,2240,78447,73057,5390,74388,72996,5.00,194340,178275,263527,109088,215516,37151,628,10232,85174,266724,20717,252867,89310,144149,8924,4293,6191,312211,28253,29984,331,242,417,1177,288748,83867
Sabah,Lahad Datu,2020,229138,7444,49549,48007,1542,49147,48489,4.60,121815,107323,146081,83057,130963,10108,394,4616,55982,161865,11291,155732,56690,88842,4795,2105,3300,202382,18379,7471,202,161,37,506,97405,131733
Sabah,Semporna,2020,166587,1145,31553,28350,3203,29042,28957,5.70,85401,81186,102740,63847,100694,1007,79,960,43261,116057,7269,103018,38380,58008,4549,1924,157,161797,2084,663,86,74,1882,1,83337,83250
Sabah,Sandakan,2020,439050,2266,86134,76809,9325,82064,79472,5.30,226049,213001,298024,141026,239009,52863,818,5334,104481,309403,25166,307837,127401,155524,9111,4939,10862,353165,39280,42897,416,832,1105,1355,334374,104676
Sabah,Kinabatangan,2020,143112,6605,32969,31829,1140,32021,31708,4.50,79600,63512,42758,100354,39256,316,91,3095,25877,112733,4502,96953,34294,58551,1984,1148,976,131304,11525,109,127,12,5,30,18642,124470
Sabah,Beluran,2020,77125,5498,23094,19241,3853,19953,19408,3.80,41675,35450,43723,33402,42931,249,41,502,18534,54920,3671,51226,14268,33115,1320,507,2016,63648,12755,140,168,7,400,7,0,77125
Sabah,Kota Kinabalu,2020,500421,351,112750,101734,11016,113507,110145,4.40,256739,243682,413799,86622,330374,77306,2022,4097,131606,336891,31924,362861,131466,213365,8525,5729,3776,304838,148336,41865,1482,928,2779,193,470204,30217
Sabah,Ranau,2020,85077,3608,17807,16787,1020,16441,16260,5.10,44006,41071,79650,5427,78677,751,36,186,26922,52078,6077,61435,25096,33680,1734,538,387,38567,45666,717,72,17,27,11,21262,63815
Sabah,Kota Belud,2020,107243,1386,21393,19938,1455,20823,20751,5.10,53945,53298,103170,4073,100909,1804,78,379,32148,68720,6375,75205,28690,42292,3159,1064,0,69752,36700,454,137,17,183,0,22395,84848
Sabah,Tuaran,2020,135665,1166,34254,29105,5149,29281,29142,4.60,68892,66773,128188,7477,124083,3035,159,911,41546,86121,7998,95739,33665,55985,4108,1717,264,84285,49119,2030,118,58,49,6,60761,74904
Sabah,Penampang,2020,162174,425,44577,40202,4375,41400,41028,3.70,85808,76366,143842,18332,108532,33104,517,1689,42572,108609,10993,123027,44345,72761,3059,2279,583,53607,83339,23294,284,661,979,10,147589,14585
Sabah,Papar,2020,150667,1243,35354,30508,4846,31066,30615,4.80,78791,71876,138188,12479,131565,5543,160,920,51488,92172,7007,113661,49266,58239,3282,1439,1435,105614,40381,4330,89,117,115,21,85964,64703
Sabah,Kudat,2020,86410,1287,19795,17504,2291,18023,17824,4.70,43921,42489,78373,8037,73387,4701,39,246,23857,56944,5609,58115,21373,32606,2332,894,910,50087,32042,3605,93,160,354,69,36915,49495
Sabah,Kota Marudu,2020,69528,1917,18876,15784,3092,16299,16248,4.30,35733,33795,66697,2831,64887,1443,44,323,21687,43160,4681,46670,14648,28731,2257,1030,4,27363,40559,670,95,91,750,0,15218,54310
Sabah,Pitas,2020,36660,1419,10419,8670,1749,8715,8705,4.20,18926,17734,34802,1858,34372,280,16,134,10617,23526,2517,25084,8748,14517,1332,487,0,21984,13765,115,110,148,538,0,0,36660
Sabah,Beaufort,2020,75716,1735,17906,14969,2937,16504,16401,4.60,38757,36959,69713,6003,64868,4196,114,535,25429,46035,4252,55310,19666,32552,2403,681,8,60739,10464,4070,165,68,208,2,17927,57789
Sabah,Kuala Penyu,2020,23710,453,6204,5268,936,5333,5276,4.40,11863,11847,22637,1073,22187,266,15,169,8202,14285,1223,16880,5599,10103,733,253,192,15256,7937,492,6,9,6,4,0,23710
Sabah,Sipitang,2020,37828,2732,9007,7899,1108,8226,8111,4.60,19671,18157,33729,4099,32951,569,44,165,12348,23380,2100,26266,8832,15984,811,342,297,26785,10543,442,18,3,5,32,16524,21304
Sabah,Tenom,2020,51328,2409,12559,11078,1481,10917,10821,4.70,26375,24953,48881,2447,46886,1749,23,223,15857,32079,3392,36328,14117,20355,1224,394,238,13678,36144,1410,20,25,47,4,0,51328
Sabah,Nabawan,2020,28349,6089,6076,4938,1138,5310,5306,5.30,15078,13271,27175,1174,27056,70,3,46,8857,17974,1518,20350,9187,10557,428,162,16,7471,20768,22,76, . ,12,0,0,28349
Sabah,Keningau,2020,150927,3533,37110,34209,2901,34540,34403,4.40,77952,72975,132862,18065,124216,7247,147,1252,43560,97826,9541,103113,35221,63180,3251,1373,88,64706,79581,5895,451,51,236,7,61016,89911
Sabah,Tambunan,2020,31573,1347,7311,7021,290,7215,7188,4.40,16058,15515,30219,1354,29982,181,7,49,10085,19251,2237,21078,7256,12388,1065,369,0,6236,25181,75,46,1,34,0,0,31573
Sabah,Kunak,2020,68893,1134,13373,11090,2283,11885,11719,5.80,37200,31693,34228,34665,31496,614,79,2039,15824,50237,2832,43797,17797,23621,1511,621,247,66126,2350,350,33,30,4,0,21957,46936
Sabah,Tongod,2020,42742,10054,11231,9838,1393,10380,10366,4.10,23126,19616,26463,16279,26176,194,22,71,10766,29679,2297,27511,8116,18416,722,240,17,22663,19740,164,148,8,19,0,0,42742
Sabah,Putatan,2020,68811,40,17470,15116,2354,15870,15783,4.30,35590,33221,63490,5321,58188,3955,294,1053,23727,41580,3504,50483,18981,29006,1500,985,11,54835,11866,1893,86,51,80,0,68811,0
Sabah,Telupid,2020,29241,2210,8935,7859,1076,7827,7801,3.70,15992,13249,17833,11408,17037,145,87,564,6860,20960,1421,20200,8314,11281,354,235,16,15754,13383,54,23, . ,27,0,0,29241
Sabah,Kalabakan,2020,48195,3885,12870,11435,1435,12024,11380,4.00,26503,21692,17550,30645,17273,73,5,199,9867,36512,1816,32711,9510,20353,919,359,1570,44363,3594,30,66,1,2,139,0,48195
Sarawak,Kuching,2020,609205,1498,180026,136292,43734,142732,140416,4.30,307666,301539,599228,9977,376481,218716,2562,1469,133423,426714,49068,475782,187367,256341,19738,10819,1517,247593,199223,149807,1644,2426,6994,1518,558113,51092
Sarawak,Bau,2020,52643,884,15187,11176,4011,11279,11180,4.70,27339,25304,51525,1118,42666,8654,93,112,10647,37133,4863,41996,16948,21947,2283,744,74,6234,38422,7219,14,353,327,74,0,52643
Sarawak,Lundu,2020,33479,1812,11478,8532,2946,8791,8758,3.80,17956,15523,30815,2664,27502,3166,25,122,7887,22800,2792,25592,8756,14924,1359,553,0,13423,16651,2607,18,537,243,0,0,33479
Sarawak,Samarahan,2020,128284,407,42499,28007,14492,37080,29489,3.70,62212,66072,126866,1418,102875,23010,697,284,28094,94798,5392,100190,46345,49374,2952,1519,0,63679,46621,16611,504,363,506,0,106650,21634
Sarawak,Serian,2020,85345,1749,29766,21656,8110,21663,21643,3.90,43818,41527,83712,1633,69080,14412,124,96,18187,58512,8646,67158,21271,40434,4280,1173,0,13619,58786,12171,60,641,68,0,20531,64814
Sarawak,Simunjan,2020,36211,2218,11972,9052,2920,8972,8945,4.00,19077,17134,34012,2199,32862,892,4,254,8123,24430,3658,28088,9746,16375,1398,569,0,22283,13108,610,12,126,72,0,0,36211
Sarawak,Sri Aman,2020,61238,2324,17871,13405,4466,13306,13262,4.60,31710,29528,59876,1362,52493,7251,26,106,12774,41153,7311,48464,18989,25444,2987,1044,0,16407,38675,5381,26,112,637,0,27692,33546
Sarawak,Lubok Antu,2020,24573,3143,8309,6734,1575,6478,6470,3.80,12490,12083,23866,707,22428,1393,10,35,4653,16609,3311,19920,5575,12445,1489,411,0,1512,21632,1088,5,118,218,0,0,24573
Sarawak,Betong,2020,36303,1547,12132,8777,3355,8873,8781,4.10,18874,17429,35956,347,34596,1318,8,34,7452,25017,3834,28851,11479,15134,1758,480,0,15591,19654,907,7,55,89,0,0,36303
Sarawak,Saratok,2020,23105,888,7594,5545,2049,5478,5459,4.20,11383,11722,22862,243,21655,1178,6,23,4207,16708,2190,18898,7383,10359,777,379,0,6771,15065,1115,3,40,111,0,0,23105
Sarawak,Sarikei,2020,44039,985,16794,11624,5170,11825,11594,3.80,22121,21918,43546,493,26539,16904,31,72,9832,30147,4060,34207,11058,20376,1829,744,200,11531,20070,8317,16,157,3748,200,26018,18021
Sarawak,Maradong,2020,20299,719,7610,5148,2462,5138,5101,3.90,10127,10172,19884,415,12398,7407,3,76,4940,13566,1793,15359,4950,9091,869,375,74,4552,11357,2282,2,211,1821,74,7662,12637
Sarawak,Daro,2020,19477,1226,5980,4904,1076,5236,5220,3.70,10528,8949,17282,2195,16970,249,4,59,5013,13091,1373,14464,5904,7566,688,306,0,17495,1807,124,3,42,6,0,0,19477
Sarawak,Julau,2020,15333,1703,5487,3888,1599,3855,3850,4.00,7613,7720,15313,20,14882,412,2,17,3497,10196,1640,11836,3000,7574,915,347,0,343,14164,193,0,196,437,0,0,15333
Sarawak,Sibu,2020,248064,2230,84867,62358,22509,66409,63479,3.80,127822,120242,234837,13227,119472,114477,248,640,51862,176042,20160,196202,66288,110833,9724,4076,5281,50017,149067,34328,212,864,8293,5283,209898,38166
Sarawak,Dalat,2020,21147,905,5901,4891,1010,5551,5545,3.80,10932,10215,18328,2819,17182,1130,4,12,4771,14266,2110,16376,5823,9199,1058,296,0,12363,6745,520,2,23,1494,0,0,21147
Sarawak,Mukah,2020,42275,2536,14573,11221,3352,11938,11527,3.50,22424,19851,37737,4538,34486,3140,28,83,9719,29872,2684,32556,11721,18954,1426,455,0,19930,17566,1708,58,1216,1797,0,17025,25250
Sarawak,Kanowit,2020,24700,2254,9744,6790,2954,6720,6710,3.70,12349,12351,24233,467,22057,2141,4,31,5800,16055,2845,18900,5303,11499,1599,499,0,1765,20955,1465,16,32,467,0,0,24700
Sarawak,Bintulu,2020,178646,1991,46979,41223,5756,42791,41713,4.20,96710,81936,162640,16006,128476,33326,287,551,43090,129854,5702,135556,49805,78928,3046,2105,1672,58255,104771,11742,347,723,1136,1672,153125,25521
Sarawak,Tatau,2020,31920,4946,8010,7371,639,7381,7277,4.30,17542,14378,28455,3465,26954,1327,13,161,7763,22509,1648,24157,7858,14848,838,316,297,5960,24764,660,7,148,84,297,0,31920
Sarawak,Kapit,2020,36030,3973,11771,8790,2981,8959,8949,4.00,18134,17896,35643,387,33110,2482,24,27,9442,23872,2716,26588,8158,16197,1489,744,0,2351,32269,1266,10,116,18,0,15234,20796
Sarawak,Song,2020,9961,3935,4876,3008,1868,2942,2939,3.40,4878,5083,9935,26,9392,536,1,6,2492,6237,1232,7469,1770,5008,556,135,0,690,7899,236,2,1010,124,0,0,9961
Sarawak,Belaga,2020,22502,19050,8324,6024,2300,6808,6177,3.50,12958,9544,19511,2991,19025,350,8,128,4635,17227,640,17867,6615,10020,384,191,657,2294,19394,125,5,10,17,657,0,22502
Sarawak,Miri,2020,248877,5143,81646,60945,20701,62093,61679,3.90,130545,118332,236227,12650,161098,73693,699,737,49853,183430,15594,199024,76901,107318,7579,3917,3309,70749,127372,43923,353,743,2423,3314,233945,14932
Sarawak,Marudi,2020,18838,3079,6967,5075,1892,5408,5393,3.50,10089,8749,16477,2361,14286,2001,13,177,4176,13297,1365,14662,5103,8850,472,237,0,4999,12204,1461,8,79,87,0,0,18838
Sarawak,Limbang,2020,45061,3978,13849,10374,3475,11069,11056,4.10,23191,21870,43856,1205,38603,5114,34,105,11566,30344,3151,33495,11234,19462,1960,839,0,20256,21041,3024,21,374,345,0,23371,21690
Sarawak,Lawas,2020,36604,3812,9902,7823,2079,8632,8606,4.20,18724,17880,34790,1814,32228,2385,24,153,9774,24067,2763,26830,9527,15696,1186,421,0,19773,15389,1379,21,24,18,0,0,36604
Sarawak,Matu,2020,16316,1600,6684,5052,1632,5536,5530,2.90,8842,7474,13982,2334,13594,333,0,55,3463,11460,1393,12853,5001,6976,686,190,0,12345,3685,174,0,17,95,0,0,16316
Sarawak,Asajaya,2020,33606,303,7577,6395,1182,8065,8057,4.20,17141,16465,33319,287,31770,1533,5,11,8423,21974,3209,25183,8863,14346,1498,476,0,29688,2680,1197,1,36,4,0,0,33606
Sarawak,Pakan,2020,15462,925,4502,3460,1042,3377,3374,4.60,8160,7302,15405,57,15168,199,0,38,3481,10596,1385,11981,4244,6702,713,322,0,204,13654,62,0,164,1378,0,0,15462
Sarawak,Selangau,2020,19844,3795,7601,5897,1704,5746,5738,3.40,10235,9609,18643,1201,18163,451,3,26,4185,13787,1872,15659,4491,9688,916,564,0,1419,15510,50,1,379,2485,0,0,19844
Sarawak,Tebedu,2020,25232,656,6532,5070,1462,5649,5645,4.50,12807,12425,24852,380,24356,445,30,21,5456,17536,2240,19776,6874,11447,1144,311,0,1667,23488,74,0,2,1,0,0,25232
Sarawak,Pusa,2020,19557,947,5393,4394,999,4605,4504,4.30,10054,9503,18856,701,18675,163,2,16,6140,11966,1451,13417,4130,8128,905,254,0,18403,1011,117,3,8,15,0,0,19557
Sarawak,Kabong,2020,18404,799,5521,4188,1333,4234,4223,4.40,9265,9139,18293,111,17473,800,0,20,3978,12513,1913,14426,5019,8147,1028,232,0,9344,7764,577,1,72,646,0,0,18404
Sarawak,Tanjung Manis,2020,7946,731,3814,2263,1551,2539,2536,3.10,4219,3727,7323,623,7201,109,1,12,1749,5535,662,6197,2231,3518,342,106,0,6317,1241,47,2,122,217,0,0,7946
Sarawak,Sebauh,2020,29606,5229,10331,9384,947,9363,9347,3.20,16764,12842,20687,8919,19916,690,10,71,5375,23305,926,24231,7208,16313,487,223,0,10606,18653,194,8,111,34,0,0,29606
Sarawak,Bukit Mabong,2020,10155,11976,4541,3940,601,3677,3671,2.80,6203,3952,9447,708,9261,168,4,14,2245,6952,958,7910,2435,4864,434,177,0,660,9239,100,6,12,138,0,0,10155
Sarawak,Subis,2020,57289,3821,20236,16128,4108,16490,15925,3.40,31897,25392,42630,14659,40242,1969,24,395,11386,42551,3352,45903,14443,26074,2000,569,2817,26089,25283,1494,20,1172,411,2820,0,57289
Sarawak,Beluru,2020,28695,4905,9908,6424,3484,7284,6744,4.20,15433,13262,20277,8418,19693,488,19,77,6562,20351,1782,22133,6405,13675,870,521,662,10972,15855,250,3,568,385,662,0,28695
Sarawak,Telang Usan,2020,17406,9829,6308,3708,2600,4136,4130,4.20,9329,8077,17271,135,17051,210,2,8,4069,12269,1068,13337,4833,7848,500,156,0,406,16919,74,0,7,0,0,0,17406
W.P. Kuala Lumpur,W.P. Kuala Lumpur,2020,1982112,243,634639,542210,92429,573529,562225,3.30,1058906,923206,1773666,208446,846339,737161,178099,12067,395822,1455903,130387,1530310,467509,891276,45630,25037,100858,897637,127695,639619,162926,35045,18308,100882,1982112,0
W.P. Labuan,W.P. Labuan,2020,95120,92,22879,18082,4797,23961,23658,3.90,48890,46230,84288,10832,72671,9843,891,883,26013,65111,3996,69107,24798,40115,2651,1543,0,73460,13118,7676,612,188,66,0,84605,10515
W.P. Putrajaya,W.P. Putrajaya,2020,109202,49,38056,28773,9283,29699,29398,3.70,53574,55628,106381,2821,104144,670,1303,264,41460,66207,1535,67742,18587,45588,1365,1481,721,106132,880,533,1152,98,69,338,109202,0
